Not available=不可用
P + Q algorithm=P + Q 算法
System Overview=系统总览
Unraid server=Unraid 服务器
Unraid system=Unraid 系统
Cache Memory=缓存
Ethernet=以太网
Memory Devices=内存设备
Memory Summary=内存摘要
Title=标题
Information=信息
Manufacturer=制造商
Product Name=产品名称
Serial Number=序列号
Part Number=料号
Voltage=电压
Core Count=核心数
Thread Count=线程数
Characteristics=特性
Max Speed=最大睿频频率
Current Speed=当前频率
External Clock=外频
Vendor=供应商
Release Date=发布日期
Address=地址
Runtime Size=运行时大小
ROM Size=ROM 大小
BIOS Revision=BIOS 修订版本
Features=特性
Location In Chassis=机箱内位置
Socket Designation=插槽编号
Family=产品家族
Signature=签名
Flags=指令集
Base Board Information=主板基础信息
Asset Tag=资产标签
Processor Information=处理器信息
Core Enabled=可用核心
Cache Information=缓存信息
Installed Size=安装容量
Maximum Size=最大容量
Operational Mode=运行模式
Supported SRAM Types=支持的 SRAM 类型
Installed SRAM Type=安装的 SRAM 类型
Speed=速度
Configuration=配置
Error Correction Type=纠错类型 
System Type=系统类型
Associativity=关联方式
Memory Device=内存设备
Form Factor=外形尺寸
Minimum Voltage=最小电压
Maximum Voltage=最大电压
Configured Voltage=配置电压
Memory Technology=内存技术
Maximum Capacity=最大内存大小
Number Of Devices=插槽数量
Physical Memory Array=物理内存组
Supported link modes=支持的链接模式
Supported ports=支持的接口
Supports auto-negotiation=自动协商
Auto-negotiation=自动协商